111111111111111111111111111111111111111111111111111111111111111
122222222222222222221122222222222222222221122222222222222222221
121110101111101011121121110101111101011121121110101111101011121
131110101111101011131131110101111101011131131110101111101011131
121110101111101011121121110101111101011121121110101111101011121
122222222222222222221122222222222222222222222222222222222222221
111000000010000000111111000000010000000111111000000010000000111
001000000010000000100001000000010000000100001000000010000000100
001000000010000000100001000000010000000100001000000010000000100
111000000010000000111111000000010000000111111000000010000000111
100000000010000000001100000000010000000001100000000010000000001
100666600010000000001100666600010000000001100666600010000000001
100000000010000000001100000000010000000001100000000010000000001
100000011111110000001100000011111110000001100000011111110000001
100000011111110000001100000011111110000001100000011111110000001
100000011111110000001100000011111110000001100000011111110000001
100000000000000000000000000000000000000001100000000000000000001
111111111111111111111111111111111111111111111111111111111111111
