111111111111111111111
122222222222222222221
121110101111101011121
131110101111101011131
121110101111101011121
122222222222222222221
111000002010200000111
001000020010020000100
001022222010222220100
111021112010211120111
100021112010211120001
100020002010200026061
122222002010200222221
122122011111110221221
121112111111111211121
122122011111110221221
122222500000000222221
111111111111111111111
